,date,daily_confirmed,acc_confirmed,daily_hos_add,acc_death,acc_recovered,serious,daily_death,effR
0,2020-03-06,6,58,58,0,0,8,0,2.06
1,2020-03-07,6,64,64,0,0,8,0,2.38
2,2020-03-08,0,64,64,0,0,8,0,1.92
3,2020-03-09,0,64,64,0,0,7,0,2.48
4,2020-03-10,3,67,67,0,0,8,0,2.38
5,2020-03-11,6,73,73,0,0,7,0,2.31
6,2020-03-12,2,75,75,0,0,7,0,1.3
7,2020-03-13,2,77,77,0,0,8,0,0.9
8,2020-03-14,10,87,87,0,0,8,0,0.89
9,2020-03-15,3,90,90,0,0,8,0,1.03
10,2020-03-16,0,90,90,0,0,8,0,1.03
11,2020-03-17,12,102,102,0,0,8,0,1.2
12,2020-03-18,9,111,79,2,30,8,2,1.21
13,2020-03-19,7,118,85,2,31,9,0,1.56
14,2020-03-20,11,129,95,3,31,9,1,2.05
15,2020-03-21,7,136,101,4,31,9,1,1.72
16,2020-03-22,3,139,104,4,31,9,0,1.57
17,2020-03-23,16,155,120,4,31,11,0,1.92
18,2020-03-24,18,173,137,5,31,11,1,1.66
19,2020-03-25,41,214,178,5,31,12,0,2.04
20,2020-03-26,46,260,224,5,31,15,0,2.35
21,2020-03-27,40,300,254,6,40,15,1,2.34
22,2020-03-28,64,364,317,7,40,14,1,3.0
23,2020-03-29,72,436,388,8,40,15,1,3.62
24,2020-03-30,12,448,399,9,40,16,1,2.93
25,2020-03-31,78,526,471,15,40,16,6,3.14
26,2020-04-01,67,593,537,16,40,17,1,2.54
27,2020-04-02,98,691,635,16,40,18,0,2.21
28,2020-04-03,92,783,714,18,51,22,2,2.1
29,2020-04-04,118,901,827,23,51,22,5,1.84
30,2020-04-05,141,1042,960,30,52,24,7,1.66
31,2020-04-06,85,1127,1045,30,52,27,0,1.82
32,2020-04-07,87,1214,1131,31,52,27,1,1.61
33,2020-04-08,156,1370,1283,35,52,29,4,1.67
34,2020-04-09,183,1553,1465,36,52,30,1,1.64
35,2020-04-10,199,1752,1660,40,52,31,4,1.64
36,2020-04-11,198,1950,1858,40,52,34,0,1.61
37,2020-04-12,174,2124,2030,42,52,37,2,1.51
38,2020-04-13,100,2224,2130,42,52,40,0,1.41
39,2020-04-14,159,2383,2284,47,52,40,5,1.46
40,2020-04-15,127,2510,2405,53,52,42,6,1.31
41,2020-04-16,151,2661,2553,56,52,50,3,1.2
42,2020-04-17,206,2867,2752,63,52,54,7,1.11
43,2020-04-18,186,3053,2933,68,52,55,5,1.04
44,2020-04-19,109,3162,2794,71,297,57,3,0.97
45,2020-04-20,101,3263,2586,77,600,60,6,0.96
46,2020-04-21,123,3386,2709,77,600,61,0,0.9
47,2020-04-22,123,3509,2531,81,897,62,4,0.91
48,2020-04-23,134,3643,2619,87,937,63,6,0.92
49,2020-04-24,170,3813,2768,93,952,63,6,0.89
50,2020-04-25,119,3932,2862,100,970,62,7,0.85
51,2020-04-26,82,4014,2920,100,994,66,0,0.87
52,2020-04-27,41,4055,2776,106,1173,93,6,0.82
53,2020-04-28,113,4168,2799,108,1261,105,2,0.84
54,2020-04-29,47,4215,2827,117,1271,105,9,0.78
55,2020-04-30,59,4274,2730,120,1424,101,3,0.73
56,2020-05-01,165,4439,2795,126,1518,97,6,0.74
57,2020-05-02,154,4593,2902,141,1550,100,15,0.82
58,2020-05-03,93,4686,2974,145,1567,97,4,0.84
59,2020-05-04,87,4773,3034,150,1589,92,5,0.93
60,2020-05-05,57,4830,3068,150,1612,93,0,0.89
61,2020-05-06,37,4867,3093,155,1619,91,5,0.94
62,2020-05-07,23,4890,2798,160,1932,87,5,0.98
63,2020-05-08,39,4929,2622,171,2136,78,11,0.84
64,2020-05-09,36,4965,2633,180,2152,83,9,0.66
65,2020-05-10,22,4987,2637,180,2170,71,0,0.56
66,2020-05-11,15,5002,2628,189,2185,65,9,0.44
67,2020-05-12,27,5029,1932,196,2901,56,7,0.42
68,2020-05-13,10,5039,1797,203,3039,52,7,0.39
69,2020-05-14,30,5069,1625,212,3232,54,9,0.41
70,2020-05-15,9,5078,1473,219,3386,53,7,0.43
71,2020-05-16,14,5092,1388,230,3474,55,11,0.46
72,2020-05-17,5,5097,1348,237,3512,54,7,0.49
73,2020-05-18,10,5107,1234,241,3632,52,4,0.57
74,2020-05-19,5,5112,1020,244,3848,49,3,0.54
75,2020-05-20,5,5117,929,247,3941,44,3,0.57
76,2020-05-21,11,5128,799,256,4073,42,9,0.45
77,2020-05-22,3,5131,679,263,4189,42,7,0.48
78,2020-05-23,2,5133,633,271,4229,43,8,0.45
79,2020-05-24,14,5147,628,280,4239,41,9,0.57
80,2020-05-25,8,5155,556,288,4311,39,8,0.57
81,2020-05-26,10,5165,494,292,4379,33,4,0.73
82,2020-05-27,11,5176,467,296,4413,31,4,0.82
83,2020-05-28,15,5191,449,299,4443,32,3,1.05
84,2020-05-29,21,5212,409,302,4501,31,3,1.35
85,2020-05-30,14,5226,414,304,4508,31,2,1.8
86,2020-05-31,5,5231,416,305,4510,28,1,1.45
87,2020-06-01,13,5244,400,305,4539,29,0,1.55
88,2020-06-02,34,5278,386,306,4586,26,1,1.72
89,2020-06-03,12,5290,361,306,4623,27,0,1.6
90,2020-06-04,28,5318,363,307,4648,27,1,1.65
91,2020-06-05,20,5338,342,309,4687,26,2,1.37
92,2020-06-06,26,5364,358,311,4695,26,2,1.33
93,2020-06-07,14,5378,371,311,4696,26,0,1.49
94,2020-06-08,13,5391,364,311,4716,24,0,1.43
95,2020-06-09,12,5403,334,311,4758,23,0,1.07
96,2020-06-10,18,5421,325,311,4785,22,0,1.1
97,2020-06-11,22,5443,308,311,4824,21,0,0.99
98,2020-06-12,25,5468,299,313,4856,23,2,1.02
99,2020-06-13,24,5492,316,314,4862,22,1,0.95
100,2020-06-14,47,5539,359,314,4866,19,0,1.07
101,2020-06-15,48,5587,386,314,4887,21,0,1.23
102,2020-06-16,27,5614,362,316,4936,22,2,1.45
103,2020-06-17,16,5630,335,317,4978,20,1,1.4
104,2020-06-18,41,5671,337,317,5017,19,0,1.54
105,2020-06-19,35,5706,315,320,5071,18,3,1.54
106,2020-06-20,39,5745,341,320,5084,18,0,1.63
107,2020-06-21,34,5779,359,320,5100,18,0,1.33
108,2020-06-22,29,5808,339,321,5148,19,1,1.09
109,2020-06-23,31,5839,333,323,5183,20,2,1.05
110,2020-06-24,55,5894,354,325,5215,20,2,1.18
111,2020-06-25,48,5942,359,325,5258,19,0,1.13
112,2020-06-26,54,5996,376,325,5295,17,0,1.15
113,2020-06-27,57,6053,408,325,5320,14,0,1.15
114,2020-06-28,60,6113,442,325,5346,13,0,1.27
115,2020-06-29,58,6171,451,325,5395,12,0,1.43
116,2020-06-30,54,6225,453,325,5447,10,0,1.47
117,2020-07-01,67,6292,493,325,5474,10,0,1.34
118,2020-07-02,107,6399,534,325,5540,9,0,1.45
119,2020-07-03,124,6523,616,325,5582,9,0,1.53
120,2020-07-04,131,6654,712,325,5617,9,0,1.61
121,2020-07-05,111,6765,798,325,5642,9,0,1.61
122,2020-07-06,102,6867,836,325,5706,8,0,1.59
123,2020-07-07,106,6973,876,325,5772,8,0,1.6
124,2020-07-08,75,7048,847,325,5876,6,0,1.58
125,2020-07-09,224,7272,968,325,5979,6,0,1.59
126,2020-07-10,243,7515,1096,325,6094,5,0,1.57
127,2020-07-11,206,7721,1227,325,6169,5,0,1.51
128,2020-07-12,206,7927,1379,325,6223,5,0,1.51
129,2020-07-13,118,8045,1384,325,6336,6,0,1.46
130,2020-07-14,143,8188,1391,325,6472,7,0,1.41
131,2020-07-15,165,8353,1419,326,6608,8,1,1.48
132,2020-07-16,286,8639,1542,326,6771,7,0,1.38
133,2020-07-17,293,8932,1697,326,6909,10,0,1.29
134,2020-07-18,290,9222,1893,326,7003,10,0,1.28
135,2020-07-19,188,9410,2027,326,7057,12,0,1.19
136,2020-07-20,168,9578,1939,327,7312,13,1,1.21
137,2020-07-21,237,9815,1975,327,7513,14,0,1.23
138,2020-07-22,238,10053,1959,327,7767,18,0,1.21
139,2020-07-23,366,10419,2240,327,7852,21,0,1.21
140,2020-07-24,260,10679,2438,327,7914,16,0,1.16
141,2020-07-25,295,10974,2680,328,7966,16,1,1.12
142,2020-07-26,239,11213,2761,328,8124,18,0,1.15
143,2020-07-27,131,11344,2552,328,8464,19,0,1.11
144,2020-07-28,266,11610,2524,328,8758,21,0,1.07
145,2020-07-29,250,11860,2422,329,9109,22,1,1.04
146,2020-07-30,367,12227,2459,330,9438,22,1,1.01
147,2020-07-31,462,12689,2742,332,9615,16,2,1.11
148,2020-08-01,472,13161,3081,332,9748,15,0,1.17
149,2020-08-02,292,13453,3330,332,9791,15,0,1.17
150,2020-08-03,258,13711,3266,333,10112,15,1,1.23
151,2020-08-04,309,14020,3250,333,10437,22,0,1.23
152,2020-08-05,263,14283,3263,333,10687,21,0,1.23
153,2020-08-06,360,14643,3303,333,11007,21,0,1.23
154,2020-08-07,461,15104,3410,333,11361,23,0,1.14
155,2020-08-08,429,15533,3591,333,11609,25,0,1.06
156,2020-08-09,331,15864,3753,333,11778,23,0,1.05
157,2020-08-10,197,16061,3757,334,11970,24,1,0.99
158,2020-08-11,188,16249,3693,336,12220,22,2,0.95
159,2020-08-12,222,16471,3609,336,12526,21,0,0.93
160,2020-08-13,206,16677,3491,338,12848,21,2,0.88
161,2020-08-14,389,17066,3454,338,13274,24,0,0.86
162,2020-08-15,385,17451,3517,338,13596,23,0,0.86
163,2020-08-16,260,17711,3612,340,13759,25,2,0.83
164,2020-08-17,161,17872,3516,341,14015,27,1,0.83
165,2020-08-18,207,18079,3335,344,14400,31,3,0.87
166,2020-08-19,186,18265,3106,347,14812,32,3,0.87
167,2020-08-20,339,18604,3147,348,15109,36,1,0.96
168,2020-08-21,258,18862,3103,350,15409,33,2,0.94
169,2020-08-22,256,19118,3206,350,15562,37,0,0.9
170,2020-08-23,212,19330,3254,350,15726,39,0,0.91
171,2020-08-24,95,19425,3046,352,16027,38,2,0.9
172,2020-08-25,182,19607,2892,354,16361,34,2,0.88
173,2020-08-26,236,19843,2794,356,16693,31,2,0.91
174,2020-08-27,250,20093,2732,356,17005,31,0,0.83
175,2020-08-28,226,20319,2550,358,17411,30,2,0.86
176,2020-08-29,247,20566,2678,358,17530,32,0,0.9
177,2020-08-30,148,20714,2684,360,17670,34,2,0.89
178,2020-08-31,100,20814,2592,363,17859,32,3,0.92
179,2020-09-01,170,20984,2562,364,18058,29,1,0.93
180,2020-09-02,141,21125,2522,364,18239,29,0,0.86
181,2020-09-03,211,21336,2484,365,18487,27,1,0.88
182,2020-09-04,136,21472,2368,369,18735,28,4,0.85
183,2020-09-05,181,21653,2409,369,18875,27,0,0.81
184,2020-09-06,116,21769,2433,369,18967,27,0,0.82
185,2020-09-07,76,21845,2302,372,19171,24,3,0.81
186,2020-09-08,170,22015,2197,378,19440,21,6,0.81
187,2020-09-09,149,22164,2198,379,19587,24,1,0.86
188,2020-09-10,276,22440,2249,379,19812,23,0,0.92
189,2020-09-11,187,22627,2228,380,20019,24,1,1.0
190,2020-09-12,226,22853,2362,382,20109,23,2,1.07
191,2020-09-13,146,22999,2446,382,20171,24,0,1.12
192,2020-09-14,80,23079,2347,384,20348,22,2,1.14
193,2020-09-15,191,23270,2281,386,20603,21,2,1.15
194,2020-09-16,163,23433,2207,389,20837,23,3,1.15
195,2020-09-17,171,23604,2194,389,21021,27,0,1.04
196,2020-09-18,220,23824,2226,390,21208,26,1,1.03
197,2020-09-19,218,24042,2274,390,21378,25,0,0.99
198,2020-09-20,162,24204,2342,390,21472,27,0,0.99
199,2020-09-21,97,24301,2370,391,21540,27,1,0.99
200,2020-09-22,88,24389,2344,391,21654,30,0,0.92
201,2020-09-23,59,24448,2205,392,21851,28,1,0.85
202,2020-09-24,193,24641,2125,395,22121,29,3,0.92
203,2020-09-25,195,24836,2008,399,22429,30,4,0.89
204,2020-09-26,269,25105,2155,400,22550,29,1,0.92
205,2020-09-27,144,25249,2202,400,22647,29,0,0.9
206,2020-09-28,78,25327,2142,406,22779,26,6,0.88
207,2020-09-29,211,25538,2175,407,22956,23,1,1.02
208,2020-09-30,194,25732,2177,408,23147,21,1,1.18
209,2020-10-01,234,25966,2127,409,23430,22,1,1.19
210,2020-10-02,196,26162,2044,409,23709,22,0,1.21
211,2020-10-03,205,26367,2058,411,23898,25,2,1.13
212,2020-10-04,107,26474,2100,411,23963,26,0,1.12
213,2020-10-05,65,26539,1974,413,24152,25,2,1.13
214,2020-10-06,176,26715,1922,414,24379,25,1,1.02
215,2020-10-07,140,26855,1854,416,24585,24,2,0.91
216,2020-10-08,248,27103,1913,417,24773,22,1,0.9
217,2020-10-09,203,27306,1899,421,24986,21,4,0.9
218,2020-10-10,248,27554,1989,421,25144,24,0,0.96
219,2020-10-11,146,27700,2070,421,25209,24,0,1.0
220,2020-10-12,78,27778,1999,421,25358,25,0,1.02
221,2020-10-13,166,27944,1959,423,25562,27,2,1.03
222,2020-10-14,177,28121,1850,425,25846,25,2,1.09
223,2020-10-15,284,28405,1887,427,26091,25,2,1.1
224,2020-10-16,183,28588,1851,431,26306,25,4,1.08
225,2020-10-17,235,28823,1915,434,26474,23,3,1.05
226,2020-10-18,132,28955,1942,436,26577,24,2,1.02
227,2020-10-19,78,29033,1787,436,26810,24,0,1.01
228,2020-10-20,139,29172,1697,437,27038,24,1,1.0
229,2020-10-21,145,29317,1651,439,27227,24,2,0.96
230,2020-10-22,185,29502,1605,442,27455,24,3,0.88
231,2020-10-23,186,29688,1617,445,27626,23,3,0.9
232,2020-10-24,201,29889,1635,445,27809,25,0,0.88
233,2020-10-25,124,30013,1677,447,27889,28,2,0.89
234,2020-10-26,102,30115,1679,450,27986,29,3,0.9
235,2020-10-27,158,30273,1604,451,28218,33,1,0.92
236,2020-10-28,171,30444,1620,451,28373,30,0,0.96
237,2020-10-29,220,30664,1685,453,28526,29,2,1.04
238,2020-10-30,203,30867,1694,455,28718,31,2,1.05
239,2020-10-31,215,31082,1741,455,28886,33,0,1.08
240,2020-11-01,116,31198,1785,455,28958,34,0,1.08
241,2020-11-02,87,31285,1724,459,29102,32,4,1.06
242,2020-11-03,209,31494,1808,459,29227,32,0,1.08
243,2020-11-04,122,31616,1746,459,29411,35,0,1.03
244,2020-11-05,269,31885,1809,461,29615,38,2,1.04
245,2020-11-06,242,32127,1827,461,29839,37,0,1.05
246,2020-11-07,294,32421,1984,461,29976,36,0,1.09
247,2020-11-08,189,32610,2122,461,30027,36,0,1.13
248,2020-11-09,156,32766,2125,462,30179,35,1,1.18
249,2020-11-10,293,33059,2134,465,30460,33,3,1.19
250,2020-11-11,316,33375,2224,468,30683,38,3,1.34
251,2020-11-12,392,33767,2343,470,30954,39,2,1.36
252,2020-11-13,374,34141,2486,470,31185,39,0,1.4
253,2020-11-14,352,34493,2655,470,31368,41,0,1.37
254,2020-11-15,255,34748,2801,470,31477,38,0,1.34
255,2020-11-16,180,34928,2752,472,31704,40,2,1.31
256,2020-11-17,298,35226,2748,476,32002,42,4,1.26
257,2020-11-18,486,35712,3014,476,32222,39,0,1.22
258,2020-11-19,531,36243,3221,476,32546,38,0,1.22
259,2020-11-20,522,36765,3334,477,32954,37,1,1.21
260,2020-11-21,539,37304,3602,478,33224,40,1,1.24
261,2020-11-22,390,37694,3832,479,33383,40,1,1.26
262,2020-11-23,315,38009,3935,479,33595,41,0,1.29
263,2020-11-24,188,38197,3754,479,33964,51,0,1.25
264,2020-11-25,402,38599,3712,482,34405,54,3,1.16
265,2020-11-26,482,39081,3783,485,34813,60,3,1.1
266,2020-11-27,570,39651,3745,488,35418,61,3,1.07
267,2020-11-28,561,40212,3991,488,35733,67,0,1.02
268,2020-11-29,419,40631,4102,488,36041,67,0,1.0
269,2020-11-30,312,40943,4041,489,36413,70,1,0.96
270,2020-12-01,370,41313,3939,494,36880,62,5,1.03
271,2020-12-02,501,41814,3967,499,37348,59,5,1.08
272,2020-12-03,532,42346,4176,501,37669,54,2,1.11
273,2020-12-04,459,42805,4252,509,38044,53,8,1.06
274,2020-12-05,584,43389,4495,511,38383,55,2,1.06
275,2020-12-06,328,43717,4601,511,38605,54,0,1.03
276,2020-12-07,301,44018,4377,517,39124,55,6,1.03
277,2020-12-08,354,44372,4291,523,39558,60,6,0.98
278,2020-12-09,574,44946,4448,528,39970,59,5,0.98
279,2020-12-10,601,45547,4642,530,40375,59,2,0.98
280,2020-12-11,596,46143,4638,535,40970,67,5,1.04
281,2020-12-12,621,46764,4932,535,41297,68,0,1.04
282,2020-12-13,481,47245,5155,535,41555,70,0,1.1
283,2020-12-14,305,47550,5029,538,41983,73,3,1.11
284,2020-12-15,457,48007,4839,547,42621,78,9,1.13
285,2020-12-16,681,48688,5090,557,43041,69,10,1.14
286,2020-12-17,822,49510,5370,557,43583,66,0,1.16
287,2020-12-18,664,50174,5462,561,44151,66,4,1.14
288,2020-12-19,736,50910,6145,566,44199,62,5,1.16
289,2020-12-20,556,51466,6098,566,44802,66,0,1.14
290,2020-12-21,397,51863,6012,567,45284,63,1,1.15
291,2020-12-22,570,52433,5892,568,45973,64,1,1.15
292,2020-12-23,758,53191,6088,578,46525,69,10,1.14
293,2020-12-24,895,54086,6327,587,47172,73,9,1.11
294,2020-12-25,890,54976,6628,597,47751,81,10,1.13
295,2020-12-26,954,55930,7202,607,48121,81,10,1.15
296,2020-12-27,708,56638,7589,607,48442,82,0,1.16
297,2020-12-28,491,57129,7584,613,48932,81,6,1.15
298,2020-12-29,869,57998,7754,618,49626,84,5,1.18
299,2020-12-30,961,58959,8354,622,49983,85,4,1.19
300,2020-12-31,1353,60312,9320,627,50365,89,5,1.25
301,2021-01-01,793,61105,9613,631,50861,88,4,1.19
302,2021-01-02,829,61934,10008,631,51295,94,0,1.14
303,2021-01-03,826,62760,10471,632,51657,101,1,1.13
304,2021-01-04,905,63665,10995,634,52036,108,2,1.17
305,2021-01-05,1315,64980,11686,648,52646,111,14,1.18
306,2021-01-06,1640,66620,12708,656,53256,113,8,1.22
307,2021-01-07,2520,69140,14521,667,53952,121,11,1.28
308,2021-01-08,2459,71599,16151,674,54774,129,7,1.47
309,2021-01-09,2332,73931,17707,682,55542,129,8,1.64
310,2021-01-10,1510,75441,18710,685,56046,128,3,1.68
311,2021-01-11,1252,76693,19453,689,56551,131,4,1.64
312,2021-01-12,1025,77718,19614,691,57413,144,2,1.54
313,2021-01-13,1480,79198,19839,704,58655,141,13,1.42
314,2021-01-14,1552,80750,20135,707,59908,135,3,1.22
315,2021-01-15,2044,82794,20522,717,61555,133,10,1.05
316,2021-01-16,1839,84633,20634,720,63279,136,3,0.92
317,2021-01-17,1595,86228,21404,725,64099,138,5,0.89
318,2021-01-18,1217,87445,21548,728,65169,143,3,0.87
319,2021-01-19,1253,88698,21073,744,66881,155,16,0.9
320,2021-01-20,1286,89984,20329,754,68901,160,10,0.9
321,2021-01-21,1485,91469,20291,761,70417,159,7,0.94
322,2021-01-22,1184,92653,19528,770,72355,158,9,0.91
323,2021-01-23,1079,93732,19063,779,73890,156,9,0.89
324,2021-01-24,986,94718,19055,782,74881,156,3,0.84
325,2021-01-25,619,95337,18144,796,76397,148,14,0.8
326,2021-01-26,1026,96363,17526,809,78028,148,13,0.77
327,2021-01-27,976,97339,16952,827,79560,159,18,0.76
328,2021-01-28,1065,98404,15790,847,81767,150,20,0.73
329,2021-01-29,871,99275,14643,864,83768,147,17,0.75
330,2021-01-30,770,100045,14220,883,84942,141,19,0.77
331,2021-01-31,634,100679,14095,886,85698,140,3,0.78
332,2021-02-01,393,101072,12557,894,87621,133,8,0.8
333,2021-02-02,556,101628,11603,917,89108,129,23,0.76
334,2021-02-03,676,102304,10692,949,90663,125,32,0.76
335,2021-02-04,734,103038,9954,974,92110,115,25,0.75
336,2021-02-05,577,103615,9225,996,93394,117,22,0.74
337,2021-02-06,639,104254,8555,1017,94682,114,21,0.75
338,2021-02-07,429,104683,8012,1023,95648,111,6,0.75
339,2021-02-08,276,104959,7337,1035,96587,104,12,0.76
340,2021-02-09,412,105371,6812,1053,97506,104,18,0.78
341,2021-02-10,491,105862,6656,1078,98128,103,25,0.79
342,2021-02-11,434,106296,6638,1099,98559,103,21,0.78
343,2021-02-12,307,106603,6182,1114,99307,102,15,0.77
344,2021-02-13,369,106972,6095,1125,99752,104,11,0.73
345,2021-02-14,371,107343,6042,1131,100170,103,6,0.75
346,2021-02-15,266,107609,5592,1137,100880,97,6,0.76
347,2021-02-16,350,107959,4611,1164,102184,92,27,0.77
348,2021-02-17,378,108337,4358,1183,102796,87,19,0.77
349,2021-02-18,445,108782,4370,1210,103202,84,27,0.82
350,2021-02-19,353,109135,4247,1221,103667,84,11,0.89
351,2021-02-20,327,109462,4244,1248,103970,82,27,0.94
352,2021-02-21,272,109734,4152,1265,104317,82,17,0.93
353,2021-02-22,178,109912,3825,1274,104813,76,9,0.9
354,2021-02-23,275,110187,3775,1285,105127,77,11,0.9
355,2021-02-24,213,110400,3503,1302,105595,69,17,0.88
356,2021-02-25,340,110740,3460,1325,105955,71,23,0.84
357,2021-02-26,270,111010,3344,1355,106311,70,30,0.81
358,2021-02-27,337,111347,3342,1370,106635,68,15,0.82
359,2021-02-28,329,111676,3374,1376,106926,67,6,0.86
360,2021-03-01,121,111797,3091,1395,107311,61,19,0.87
361,2021-03-02,232,112029,3083,1400,107546,54,5,0.87
362,2021-03-03,316,112345,2979,1419,107947,52,19,0.96
363,2021-03-04,279,112624,2939,1442,108243,51,23,0.97
364,2021-03-05,301,112925,2884,1454,108587,49,12,1.02
365,2021-03-06,293,113218,2892,1462,108864,51,8,0.99
366,2021-03-07,237,113455,2896,1462,109097,52,0,0.94
367,2021-03-08,116,113571,2699,1479,109393,46,17,0.96
368,2021-03-09,290,113861,2660,1500,109701,39,21,1.0
369,2021-03-10,340,114201,2651,1518,110032,39,18,0.97
370,2021-03-11,335,114536,2668,1536,110332,39,18,1.01
371,2021-03-12,304,114840,2657,1561,110622,37,25,1.0
372,2021-03-13,330,115170,2746,1577,110847,40,16,1.03
373,2021-03-14,239,115409,2757,1580,111072,41,3,1.07
374,2021-03-15,175,115584,2628,1589,111367,42,9,1.09
375,2021-03-16,300,115884,2678,1605,111601,42,16,1.07
376,2021-03-17,409,116293,2797,1612,111884,41,7,1.09
377,2021-03-18,323,116616,2831,1624,112161,44,12,1.06
378,2021-03-19,303,116919,2819,1630,112470,46,6,1.06
379,2021-03-20,342,117261,2947,1632,112682,47,2,1.05
380,2021-03-21,256,117517,2978,1636,112903,47,4,1.06
381,2021-03-22,187,117704,2817,1643,113244,47,7,1.04
382,2021-03-23,337,118041,2890,1661,113490,42,18,1.05
383,2021-03-24,420,118461,2976,1667,113818,42,6,1.03
384,2021-03-25,394,118855,3059,1674,114122,41,7,1.05
385,2021-03-26,376,119231,3074,1689,114468,45,15,1.08
386,2021-03-27,430,119661,3268,1705,114688,44,16,1.1
387,2021-03-28,313,119974,3256,1725,114993,41,20,1.12
388,2021-03-29,234,120208,3090,1737,115381,40,12,1.13
389,2021-03-30,364,120572,3135,1747,115690,39,10,1.12
390,2021-03-31,414,120986,3204,1770,116012,45,23,1.12
391,2021-04-01,475,121461,3430,1774,116257,44,4,1.11
392,2021-04-02,440,121901,3601,1776,116524,43,2,1.11
393,2021-04-03,446,122347,3658,1776,116913,48,0,1.08
394,2021-04-04,355,122702,3667,1776,117259,47,0,1.08
395,2021-04-05,249,122951,3570,1779,117602,46,3,1.07
396,2021-04-06,399,123350,3652,1785,117913,44,6,1.07
397,2021-04-07,555,123905,3821,1789,118295,41,4,1.11
398,2021-04-08,545,124450,3924,1794,118732,41,5,1.1
399,2021-04-09,537,124987,3976,1798,119213,43,4,1.11
400,2021-04-10,570,125557,4138,1803,119616,37,5,1.14
401,2021-04-11,421,125978,4162,1803,120013,39,0,1.14
402,2021-04-12,306,126284,3995,1804,120485,42,1,1.15
403,2021-04-13,510,126794,4054,1811,120929,41,7,1.17
404,2021-04-14,591,127385,4148,1819,121418,41,8,1.13
405,2021-04-15,729,128114,4410,1828,121876,37,9,1.16
406,2021-04-16,667,128781,4526,1836,122419,43,8,1.16
407,2021-04-17,759,129540,4819,1846,122875,45,10,1.17
408,2021-04-18,543,130083,4845,1847,123391,45,1,1.17
409,2021-04-19,405,130488,4785,1847,123856,47,0,1.18
410,2021-04-20,711,131199,4980,1852,124367,50,5,1.19
411,2021-04-21,843,132042,5314,1856,124872,48,4,1.23
412,2021-04-22,861,132903,5597,1864,125442,48,8,1.21
413,2021-04-23,759,133662,5802,1869,125991,52,5,1.2
414,2021-04-24,876,134538,6049,1872,126617,51,3,1.18
415,2021-04-25,635,135173,6034,1876,127263,50,4,1.17
416,2021-04-26,425,135598,5862,1876,127860,55,0,1.15
417,2021-04-27,828,136426,5946,1879,128601,55,3,1.13
418,2021-04-28,925,137351,6227,1880,129244,53,1,1.1
419,2021-04-29,1027,138378,6536,1889,129953,58,9,1.1
420,2021-04-30,698,139076,6555,1891,130630,65,2,1.08
421,2021-05-01,1050,140126,6836,1897,131393,63,6,1.08
422,2021-05-02,879,141005,7009,1898,132098,63,1,1.1
423,2021-05-03,708,141713,7023,1898,132792,65,0,1.14
424,2021-05-04,609,142322,6935,1899,133488,65,1,1.09
425,2021-05-05,621,142943,6911,1899,134133,69,0,1.04
426,2021-05-06,591,143534,6970,1903,134661,72,4,0.96
427,2021-05-07,907,144441,6845,1909,135687,69,6,0.99
428,2021-05-08,1121,145562,7164,1915,136483,71,6,0.98
429,2021-05-09,1032,146594,7372,1918,137304,73,3,0.97
430,2021-05-10,573,147167,7177,1920,138070,78,2,0.92
431,2021-05-11,925,148092,7169,1923,139000,81,3,0.98
432,2021-05-12,969,149061,7224,1931,139906,86,8,1.07
433,2021-05-13,1010,150071,7337,1938,140796,84,7,1.18
434,2021-05-14,854,150925,7506,1940,141479,84,2,1.14
435,2021-05-15,772,151697,7436,1951,142310,85,11,1.09
436,2021-05-16,542,152239,7235,1951,143053,84,0,1.01
437,2021-05-17,419,152658,6790,1958,143910,85,7,1.0
438,2021-05-18,732,153390,6545,1969,144876,81,11,0.94
439,2021-05-19,766,154156,6353,1984,145819,73,15,0.88
440,2021-05-20,843,154999,6453,1997,146549,69,13,0.82
441,2021-05-21,649,155648,6232,2010,147406,65,13,0.8
442,2021-05-22,602,156250,6198,2015,148037,62,5,0.81
443,2021-05-23,535,156785,5857,2017,148911,61,2,0.86
444,2021-05-24,340,157125,5519,2017,149589,68,0,0.86
445,2021-05-25,542,157667,5367,2026,150274,71,9,0.86
446,2021-05-26,743,158410,5500,2031,150879,70,5,0.88
447,2021-05-27,684,159094,5569,2042,151483,69,11,0.88
448,2021-05-28,614,159708,5429,2048,152231,70,6,0.9
449,2021-05-29,539,160247,5381,2054,152812,78,6,0.91
450,2021-05-30,448,160695,5211,2054,153430,77,0,0.9
451,2021-05-31,260,160955,4826,2055,154074,75,1,0.9
452,2021-06-01,471,161426,4774,2062,154590,70,7,0.91
453,2021-06-02,487,161913,4686,2075,155152,73,13,0.87
454,2021-06-03,508,162421,4666,2091,155664,67,16,0.86
455,2021-06-04,472,162893,4533,2095,156265,62,4,0.84
456,2021-06-05,436,163329,4440,2103,156786,62,8,0.83
457,2021-06-06,351,163680,4286,2108,157286,60,5,0.82
458,2021-06-07,235,163915,3937,2111,157867,61,3,0.83
459,2021-06-08,369,164284,3771,2121,158392,60,10,0.82
460,2021-06-09,440,164724,3739,2128,158857,57,7,0.85
461,2021-06-10,439,165163,3693,2134,159336,55,6,0.87
462,2021-06-11,435,165598,3628,2142,159828,51,8,0.89
463,2021-06-12,467,166065,3671,2150,160244,46,8,0.92
464,2021-06-13,304,166369,3618,2156,160595,47,6,0.93
465,2021-06-14,209,166578,3348,2159,161071,46,3,0.93
466,2021-06-15,337,166915,3287,2171,161457,45,12,0.94
467,2021-06-16,501,167416,3402,2183,161831,45,12,0.97
468,2021-06-17,452,167868,3463,2190,162215,40,7,0.99
469,2021-06-18,453,168321,3458,2192,162671,42,2,1.0
470,2021-06-19,388,168709,3456,2196,163057,43,4,0.98
471,2021-06-20,376,169085,3429,2197,163459,45,1,1.01
472,2021-06-21,236,169321,3269,2198,163854,47,1,1.02
473,2021-06-22,435,169756,3322,2203,164231,45,5,1.06
474,2021-06-23,619,170375,3590,2213,164572,44,10,1.07
475,2021-06-24,570,170945,3778,2216,164951,43,3,1.1
476,2021-06-25,562,171507,3970,2218,165319,38,2,1.12
477,2021-06-26,534,172041,4154,2222,165665,37,4,1.18
478,2021-06-27,386,172427,4135,2223,166069,37,1,1.16
479,2021-06-28,317,172744,4068,2227,166449,41,4,1.17
480,2021-06-29,476,173220,4148,2231,166841,43,4,1.15
481,2021-06-30,714,173934,4434,2234,167266,47,3,1.14
482,2021-07-01,673,174607,4605,2236,167766,51,2,1.13
483,2021-07-02,660,175267,4741,2238,168288,54,2,1.13
484,2021-07-03,716,175983,4981,2238,168764,50,0,1.13
485,2021-07-04,518,176501,5065,2239,169197,51,1,1.15
486,2021-07-05,342,176843,4878,2240,169725,57,1,1.14
487,2021-07-06,593,177436,4935,2241,170260,63,1,1.15
488,2021-07-07,920,178356,5360,2244,170752,62,3,1.17
489,2021-07-08,896,179252,5685,2246,171321,60,2,1.19
490,2021-07-09,822,180074,5885,2248,171941,62,2,1.19
491,2021-07-10,950,181024,6270,2253,172501,63,5,1.19
492,2021-07-11,614,181638,6246,2256,173136,61,3,1.18
493,2021-07-12,502,182140,6164,2256,173720,55,0,1.2
494,2021-07-13,830,182970,6366,2258,174346,58,2,1.21
495,2021-07-14,1149,184119,6864,2262,174993,54,4,1.21
496,2021-07-15,1308,185427,7466,2266,175695,57,4,1.23
497,2021-07-16,1271,186698,8078,2267,176353,53,1,1.26
498,2021-07-17,1410,188108,8764,2269,177075,59,2,1.28
499,2021-07-18,1008,189116,8993,2269,177854,58,0,1.31
500,2021-07-19,727,189843,8881,2270,178692,60,1,1.31
501,2021-07-20,1387,191230,9485,2272,179473,60,2,1.33
502,2021-07-21,1832,193062,10396,2276,180390,64,4,1.37
503,2021-07-22,1979,195041,11637,2276,181128,65,0,1.37
504,2021-07-23,1359,196400,11957,2277,182166,68,1,1.31
505,2021-07-24,1128,197528,11881,2277,183370,74,0,1.23
506,2021-07-25,1763,199291,12635,2277,184379,72,0,1.25
507,2021-07-26,1429,200720,12831,2277,185612,78,0,1.28
508,2021-07-27,2848,203568,14372,2279,186917,82,2,1.33
509,2021-07-28,3177,206745,16344,2285,188116,80,6,1.35
510,2021-07-29,3865,210610,18910,2288,189412,81,3,1.41
511,2021-07-30,3300,213910,20817,2290,190803,88,2,1.52
512,2021-07-31,4058,217968,23319,2293,192356,95,3,1.74
513,2021-08-01,3058,221026,24774,2293,193959,101,0,1.72
514,2021-08-02,2195,223221,25431,2293,195497,114,0,1.68
515,2021-08-03,3709,226930,27585,2300,197045,112,7,1.58
516,2021-08-04,4166,231096,29703,2301,199092,115,1,1.51
517,2021-08-05,5042,236138,32664,2302,201172,135,1,1.42
518,2021-08-06,4515,240653,34235,2306,204112,141,4,1.35
519,2021-08-07,4566,245219,35906,2310,207003,150,4,1.23
520,2021-08-08,4066,249285,36481,2311,210493,151,1,1.21
521,2021-08-09,2884,252169,36075,2314,213780,157,3,1.2
522,2021-08-10,2612,254781,34902,2317,217562,176,3,1.13
523,2021-08-11,4200,258981,35689,2319,220973,197,2,1.1
524,2021-08-12,4989,263970,37938,2325,223707,218,6,1.06
525,2021-08-13,5773,269743,39802,2332,227609,227,7,1.06
526,2021-08-14,5094,274837,40906,2332,231599,245,0,1.06
527,2021-08-15,4295,279132,40525,2335,236272,251,3,1.04
528,2021-08-16,2962,282094,39318,2340,240436,268,5,1.02
529,2021-08-17,4377,286471,38867,2348,245256,276,8,1.1
530,2021-08-18,5386,291857,40197,2354,249306,275,6,1.12
531,2021-08-19,5534,297391,42545,2358,252488,274,4,1.14
532,2021-08-20,5405,302796,44503,2365,255928,273,7,1.1
533,2021-08-21,5074,307870,45456,2371,260043,270,6,1.08
534,2021-08-22,4392,312262,45373,2379,264510,271,8,1.08
535,2021-08-23,2447,314709,42665,2384,269660,272,5,1.06
536,2021-08-24,4220,318929,41654,2393,274882,268,9,1.02
537,2021-08-25,4228,323157,41368,2404,279385,277,11,0.97
538,2021-08-26,4704,327861,42460,2415,282986,276,11,0.94
539,2021-08-27,4227,332088,41886,2433,287769,294,18,0.92
540,2021-08-28,3581,335669,40698,2452,292519,297,19,0.88
541,2021-08-29,3081,338750,39311,2466,296973,296,14,0.85
542,2021-08-30,1915,340665,36266,2478,301921,287,12,0.85
543,2021-08-31,2909,343574,33993,2493,307088,287,15,0.82
544,2021-09-01,3168,346742,33118,2500,311124,286,7,0.82
545,2021-09-02,3099,349841,33356,2510,313975,291,10,0.79
546,2021-09-03,2539,352380,31508,2520,318352,278,10,0.77
547,2021-09-04,2362,354742,30334,2535,321873,267,15,0.76
548,2021-09-05,1853,356595,28064,2545,325986,264,10,0.75
549,2021-09-06,968,357563,27129,2561,327873,267,16,0.74
550,2021-09-07,1629,359192,23029,2577,333586,260,16,0.72
551,2021-09-08,1834,361026,21887,2594,336545,252,17,0.7
552,2021-09-09,1675,362701,21067,2613,339021,251,19,0.68
553,2021-09-10,1242,363943,19075,2628,342240,243,15,0.67
554,2021-09-11,1273,365216,17839,2645,344732,233,17,0.65
555,2021-09-12,1067,366283,16353,2666,347264,230,21,0.65
556,2021-09-13,611,366894,14325,2678,349891,225,12,0.65
557,2021-09-14,1004,367898,13159,2692,352047,208,14,0.66
558,2021-09-15,1052,368950,12204,2712,354034,198,20,0.66
559,2021-09-16,831,369781,11657,2736,355388,182,24,0.65
560,2021-09-17,782,370563,10914,2761,356888,179,25,0.67
561,2021-09-18,862,371425,10141,2781,358503,177,20,0.69
562,2021-09-19,565,371990,9415,2797,359778,171,16,0.69
563,2021-09-20,302,372292,8629,2801,360862,169,4,0.68
564,2021-09-21,253,372545,7383,2804,362358,152,3,0.64
565,2021-09-22,537,373082,6872,2820,363390,146,16,0.63
566,2021-09-23,531,373613,6651,2838,364124,143,18,0.65
567,2021-09-24,235,373848,5678,2853,365317,139,15,0.61
568,2021-09-25,382,374230,5298,2861,366071,131,8,0.57
569,2021-09-26,299,374529,4654,2872,367003,129,11,0.56
570,2021-09-27,154,374683,4120,2883,367680,125,11,0.56
571,2021-09-28,248,374931,3749,2891,368291,117,8,0.62
572,2021-09-29,267,375198,3532,2908,368758,107,17,0.62
573,2021-09-30,218,375416,3306,2920,369190,100,12,0.58
574,2021-10-01,200,375616,3062,2934,369620,93,14,0.64
575,2021-10-02,196,375812,2958,2947,369907,88,13,0.66
576,2021-10-03,161,375973,2785,2954,370234,88,7,0.67
577,2021-10-04,87,376060,2533,2960,370567,77,6,0.67
578,2021-10-05,144,376204,2236,2965,371003,74,5,0.64
579,2021-10-06,149,376353,1993,2975,371385,77,10,0.65
580,2021-10-07,143,376496,1869,2994,371633,70,19,0.69
581,2021-10-08,138,376634,1748,3012,371874,68,18,0.67
582,2021-10-09,82,376716,1637,3021,372058,68,9,0.67
583,2021-10-10,60,376776,1565,3028,372183,67,7,0.66
584,2021-10-11,49,376825,1400,3034,372391,62,6,0.66
585,2021-10-12,77,376902,1268,3044,372590,55,10,0.65
586,2021-10-13,72,376974,1150,3057,372767,43,13,0.64
587,2021-10-14,62,377036,1085,3069,372882,40,12,0.61
588,2021-10-15,57,377093,1023,3076,372994,39,7,0.57
589,2021-10-16,66,377159,981,3083,373095,35,7,0.6
590,2021-10-17,40,377199,923,3089,373187,35,6,0.63
591,2021-10-18,29,377228,784,3095,373349,31,6,0.63
592,2021-10-19,36,377264,731,3108,373425,26,13,0.63
593,2021-10-20,41,377305,676,3113,373516,27,5,0.64
594,2021-10-21,36,377341,626,3115,373600,24,2,0.66
595,2021-10-22,26,377367,589,3116,373662,21,1,0.69
596,2021-10-23,32,377399,600,3117,373682,22,1,0.65
597,2021-10-24,19,377418,572,3117,373729,22,0,0.62
598,2021-10-25,17,377435,518,3120,373797,20,3,0.62
599,2021-10-26,29,377464,446,3125,373893,17,5,0.65
600,2021-10-27,36,377500,426,3127,373947,16,2,0.69
601,2021-10-28,21,381586,401,3130,373990,15,3,0.69
602,2021-10-29,24,381610,378,3142,374025,14,12,0.73
603,2021-10-30,23,381633,367,3147,374054,14,5,0.78
604,2021-10-31,22,381655,368,3147,374075,14,0,0.84
605,2021-11-01,9,381664,325,3148,374126,14,1,0.85
606,2021-11-02,18,381682,315,3149,374153,14,1,0.83
607,2021-11-03,25,381707,322,3152,374168,14,3,0.8
608,2021-11-04,14,381721,293,3154,374209,12,2,0.81
609,2021-11-05,25,381746,252,3155,374274,12,1,0.83
610,2021-11-06,29,381775,265,3155,374290,12,0,0.88
611,2021-11-07,21,381796,274,3155,374302,12,0,0.87
612,2021-11-08,18,381814,270,3156,374323,10,1,0.94
613,2021-11-09,30,381844,273,3157,374349,10,1,1.04
614,2021-11-10,25,381869,267,3157,374380,10,0,1.1
615,2021-11-11,31,381900,269,3158,374408,9,1,1.22
616,2021-11-12,22,381922,250,3158,374449,8,0,1.2
617,2021-11-13,24,381946,256,3158,374467,10,0,1.14
618,2021-11-14,22,381968,248,3158,374497,10,0,1.15
619,2021-11-15,7,381975,222,3158,374530,10,0,1.05
620,2021-11-16,15,381990,219,3158,374548,10,0,0.93
621,2021-11-17,27,382017,221,3160,374571,10,2,0.94
622,2021-11-18,20,382037,199,3161,374612,10,1,0.83
623,2021-11-19,16,382053,193,3161,374634,9,0,0.81
624,2021-11-20,16,382069,191,3163,374650,9,2,0.79
625,2021-11-21,20,382089,192,3163,374669,9,0,0.78
626,2021-11-22,6,382095,163,3164,374703,8,1,0.81
627,2021-11-23,17,382112,170,3164,374713,8,0,0.88
628,2021-11-24,5,382117,160,3164,374728,8,0,0.76
629,2021-11-25,27,382144,176,3164,374739,8,0,0.84
630,2021-11-26,19,382163,162,3164,374772,7,0,0.88
631,2021-11-27,16,382179,161,3164,374789,7,0,0.92
632,2021-11-28,9,382188,157,3164,374802,7,0,0.87
633,2021-11-29,8,382154,110,3165,374814,6,1,0.88
634,2021-11-30,21,382175,168,3166,374776,6,1,0.9
635,2021-12-01,21,382196,176,3167,374788,4,1,1.15
636,2021-12-02,11,382207,166,3167,374809,4,0,0.99
637,2021-12-03,14,382221,157,3168,374831,2,1,0.93
638,2021-12-04,19,382240,163,3168,374844,2,0,0.95
639,2021-12-05,20,382260,169,3168,374858,2,0,1.11
640,2021-12-06,7,382267,150,3168,374884,3,0,1.08
641,2021-12-07,19,382286,157,3168,374896,3,0,1.04
642,2021-12-08,21,382307,163,3169,374910,3,1,0.94
643,2021-12-09,17,382324,167,3170,374922,3,1,1.08
644,2021-12-10,25,382349,166,3170,374948,3,0,1.19
645,2021-12-11,20,382369,183,3170,374951,3,0,1.17
646,2021-12-12,13,382382,176,3170,374971,3,0,1.05
647,2021-12-13,7,382389,166,3171,374987,4,1,1.06
648,2021-12-14,24,382413,187,3172,374989,4,1,1.1
649,2021-12-15,29,382442,189,3172,375016,3,0,1.15
650,2021-12-16,30,382472,206,3172,375029,3,0,1.18
651,2021-12-17,20,382492,199,3172,375056,3,0,1.08
652,2021-12-18,28,382520,227,3172,375056,3,0,1.12
653,2021-12-19,33,382553,237,3172,375079,3,0,1.27
654,2021-12-20,11,382564,239,3172,375088,3,0,1.29
655,2021-12-21,38,382602,270,3172,375095,3,0,1.33
656,2021-12-22,40,382642,296,3173,375108,3,1,1.32
657,2021-12-23,37,382679,315,3173,375126,2,0,1.27
658,2021-12-24,39,382718,335,3173,375145,2,0,1.39
659,2021-12-25,38,382756,359,3174,375158,2,1,1.38
660,2021-12-26,43,382799,375,3174,375185,2,0,1.3
661,2021-12-27,35,382834,379,3174,375216,2,0,1.36
662,2021-12-28,46,382880,395,3175,375245,2,1,1.32
663,2021-12-29,76,382956,451,3175,375265,1,0,1.38
664,2021-12-30,64,383020,489,3175,375291,1,0,1.43
665,2021-12-31,78,383078,536,3175,375302,1,0,1.45
666,2022-01-01,79,383157,558,3175,375359,1,0,1.51
667,2022-01-02,84,383241,613,3175,375388,1,0,1.57
668,2022-01-03,103,383344,696,3175,375408,1,0,1.62
669,2022-01-04,151,383495,816,3175,375439,2,0,1.8
670,2022-01-05,390,383885,1206,3175,375439,3,0,2.2
671,2022-01-06,641,384526,1827,3175,375459,3,0,2.92
672,2022-01-07,922,385448,2648,3175,375560,3,0,3.7
673,2022-01-08,1224,386672,3814,3175,375618,4,0,4.55
674,2022-01-09,1223,387895,4961,3175,375694,4,0,5.21
675,2022-01-10,871,388766,5646,3175,375880,4,0,5.26
676,2022-01-11,962,389728,6379,3175,376109,4,0,5.11
677,2022-01-12,2198,391926,8376,3175,376310,4,0,4.6
678,2022-01-13,3124,395050,10867,3176,376942,4,1,3.97
679,2022-01-14,4051,399101,14233,3177,377626,3,1,3.49
680,2022-01-15,4561,403662,17969,3178,378450,4,1,3.08
681,2022-01-16,4172,407834,21107,3178,379484,5,0,2.83
682,2022-01-17,3719,411553,23545,3179,380764,5,1,2.79
683,2022-01-18,5185,416738,27695,3179,381799,7,0,2.85
684,2022-01-19,7377,424115,33281,3181,383588,10,2,2.69
685,2022-01-20,8638,432753,40321,3181,385186,9,0,2.49
686,2022-01-21,9699,442452,48039,3181,387167,11,0,2.28
687,2022-01-22,11227,453679,56928,3184,389502,12,3,2.16
688,2022-01-23,9468,463147,62790,3184,393108,13,0,2.07
689,2022-01-24,8503,471650,66663,3185,397737,12,1,2.0
690,2022-01-25,12813,484463,74713,3185,402500,14,0,1.93
691,2022-01-26,14086,498549,83039,3190,408255,18,5,1.82
692,2022-01-27,16538,515087,95026,3193,412803,18,3,1.75
693,2022-01-28,17631,532722,105504,3196,419957,20,3,1.69
694,2022-01-29,17433,550155,114470,3199,428421,22,3,1.6
695,2022-01-30,15895,566050,120299,3200,438486,23,1,1.56
696,2022-01-31,11751,577783,122226,3201,448291,26,1,1.5
697,2022-02-01,14445,592228,125964,3206,458993,29,5,1.39
698,2022-02-02,21576,613804,139068,3212,467459,30,6,1.37
699,2022-02-03,20679,634483,156198,3216,471004,38,4,1.3
700,2022-02-04,19798,654281,155553,3224,491439,41,8,1.24
701,2022-02-05,21122,675403,161883,3234,506221,44,10,1.21
702,2022-02-06,17526,692929,165237,3239,520388,45,5,1.16
703,2022-02-07,12211,705140,162741,3247,535087,48,8,1.14
704,2022-02-08,17113,722253,164889,3258,550041,51,11,1.14
705,2022-02-09,18287,740540,169697,3269,563509,59,11,1.03
706,2022-02-10,18891,759431,179649,3282,572435,64,13,1.01
707,2022-02-11,18660,778091,182869,3291,587866,61,9,1.01
708,2022-02-12,11765,789856,178940,3298,603553,62,7,0.97
709,2022-02-13,13074,802930,173620,3310,621935,65,12,0.96
710,2022-02-14,10334,813264,169698,3317,636184,74,7,0.95
711,2022-02-15,15525,828789,168698,3333,652693,77,16,0.94
712,2022-02-16,17331,846120,173260,3354,665441,81,21,0.95
